11111111111111111111
1C0000C000000C0000C1
11100010000001000111
1000000C0M00C0000001
10C00011111111000001
1C101000000000000011
1C101000CCC000000011
1C1010C0CCC000000011
1C1M1000CCC000000011
1P0000M000000M0C00E1
11111111111111111111
